Festival 3.1 solution file
===========================
Collection: C:\Users\Hans\Desktop\Test\BadFessGenerator\test\board_4.txt

Level 1

  ##############
  #   #        #
  # $ $ $ $ #$ #
  # #$# ###  $ #
  # # .....##$##
  #  ...+..  $ #
####$# ....# # #
#    #### # $$ #
#$$#  $ $  $ # #
#   ..#        #
################

